27
......g......
......l......
......ll.....
......lll....
.....l..ll..
.....l...ll..
.....l.......
....ll....l..
...ll.....l..
...l...l..l..
..ll...l..l..
.............
..l.......l..
..l...l...l..
..l...l......
..........l..
..l.......l..
..l.......l..
.............
..l...l...l..
..l...l...l..
..ll.....ll..
...ll...ll.
....ll.ll.
.....l.l..
.....lll..
.....lll..
......l...
......l...
......l...
......l...
......s...